1111111111111111111111111111111111
1000P000E0000000000000000000000001
1C10010100100000101001000000010101
1C10010010101010001001000000010101
1000000000000000000000000000000001
1111111111111111111111111111111111