111111111111111111111111111111111
111111111E00000000000001101111111
1000000P0000000000C000000000000C1
111111111111111111111111111111111