111111111111111111111111111111111111111
10000000000000000C000000000000000000001
100011100000011100000011100000111100001
100010100000000100000000100000000100001
100010100000000100000000100000000100001
100000100000011100000011100000000100001
10C0001000C00001000000001000E0000100001
100000100000000100000000100000000100001
1000011100000111000P0011100000000100001
10E0000000C0000000000000000000000000001
111111111111111111111111111111111111111