1111111111111111111111111111111111
10000000E000000000000001P000000001
10100101001000C01010001111000010C1
1010010010101010001011100000001001
100000000000000000000C000000000001
1111111111111111111111111111111111