11111111111111111111111111111111
100100E000000000000000000000P001
10010000000001100000111111000001
10000000000010100000110011000001
10000000000100100000111111000001
10000000001000100000000011000001
10000000011111110000000110000001
10000000000000100000001100000001
10000000000000100000011000000001
10000000000000100000111111000001
10000000000000000000000000000001
10000000000000000000000000000001
11111111111111111111111111111111