11111111111111111111111111111111
10PC000000CCC000000000000E000001
11111111111111111111111111111111