1111111111111111111
100100E0000C000P001
1111111111111111111